1111111111111111111111111111111111111111
1P00000C0000000000C00000000000E0000000C1
1111111111111111111111111111111111111111
