111111111111111111111111111
1E00000000C0000000000000001
111111111111111111111111001
100011111C00000000001111001
100010C01000000000001000001
100010M01111111111001001001
100010000000001111000001001
111111111111001111111111001
1P0000000000000000000000001
111111111111111111111111111
