1111111
1P00001
110C101
1000001
1C01E11
1111111
