1111111111
1P00000001
1001111101
1C01000101
1000110011
1010000CE1
1001000001
1111111111
