111111
1P00C1
111001
1C0011
1000E1
111111
