11111111111111111111111111111111111111111111111111
1P0000000000000000000000000000000000000000000000E1
10000000000000000000111111111110000000000000000001
10000000000000000000100000000010000000000000000001
10000000000000000000100000000010000000000000000001
10000000000000000000100000000010000000000000000001
10000000000000000000100000000010000000000000000001
10000000000000000000100000000010000000000000000001
10000000000000000000100000000010000000000000000001
10000000000000000000100000000010000000000000000001
10000000000000000000100000000010000000000000000001
10000000000000000000100000000010000000000000000001
10000000000000000000100000000010000000000000000001
10000000000000000000100000000010000000000000000001
10000000000000000000100000000010000000000000000001
10000000000000000000100000000010000000000000000001
1000000000C000000000100000000010000000000000000001
10000000000000000000100000000010000000000000000001
10000000000000000000100000000010000000000000000001
10000000000000000000100000000010000000000000000001
10000000000000000000100000000010000000000000000001
10000000000000000000100000000010000000000000000001
10000000000000000000100000000010000000000000000001
10000000000000000000100000000010000000000000000001
10000000000000000000100000000010000000000000000001
10000000000000000000100000000010000000000000000001
10000000000000000000100000000010000000000000000001
10000000000000000000100000000010000000000000000001
1000000000C000000000100000000010000000000000000001
10000000000000000000100000000010000000000000000001
10000000000000000000100000000010000000000000000001
10000000000000000000100000000010000000000000000001
10000000000000000000100000000010000000000000000001
10000000000000000000100000000010000000000000000001
10000000000000000000100000000010000000000000000001
10000000000000000000100000000010000000000000000001
10000000000000000000100000000010000000000000000001
10000000000000000000100000000010000000000000000001
10000000000000000000100000000010000000000000000001
10000000000000000000100000000010000000000000000001
1000000000C000000000100000000010000000000000000001
10000000000000000000100000000010000000000000000001
10000000000000000000100000000010000000000000000001
10000000000000000000100000000010000000000000000001
10000000000000000000100000000010000000000000000001
10000000000000000000100000000010000000000000000001
10000000000000000000100000000010000000000000000001
10000000000000000000100000000010000000000000000001
10000000000000000000100000000010000000000000000001
11111111111111111111111111111111111111111111111111
