11111111111
1000000E111
10000C00001
1000P0001111
11111111111
