10111111111
10000000C11
1000000P001
11111111111
