1111111111111
1C1000E000001
1110000C00001
1C00000000001
100P000000001
1111111111111
